COMANDOS

style - Configuar na HEAD para colocar cores e faticcon
{} - colocar no style para mexer em algo como h1,p ou body
background - cor na pagína 
br - quebra de linhas
body - corpo que pode mexer em cores,colocar textos e imagens etc
img - colcocar imagens(ctrl+space)
link favicon - colocar iconé na guia
h1- texto
p - parágrafos
b - negrito
strong - negrito semântico ( utilizar esse)
ctrl + shift + p - procurar por wrap abreviation
i - italico
em - italico (semantico)
mark - marca texto colorido
small - texto pequeno
del - texto excluído
ins - texto inserido 
sup- colocar algo em cima como x elevado a 2
sub - colocar algo como menor tipo h2o
code - fonte monoespacada/ajuda na leitura para dar espaços iguas as letras
pre - faz a indetação caso tivermos feita alguma que solicita
q - citação 
blockquote - Uma citação em bloco
cite = citação para colar links do que foi colado 
ol - listar ordenadas
li - tarefas/ordens
ul - listas não ordenadas]
dt - termo/definição
dd - termo/descrição
dl - lista de definição
a - âncora para links
target - link externo junto ao rel
rel - junto ao target para abrir uma nova guia 
rel prev - Anterior
rel next - Avanço
target self - na própria aba
abbr - para deixar passar o mouse em cima e aparecer uma mensagem
picture- coloca uma imagee pode fazer uma fonte
source média type - colocar os px para diferentes dispositivos 
audio/source src/type - criar um p de audio,colocar o audio e colocar seu formato e tipo para a compatibilidade 
preload - pré carregamento
controls - controle/usar para colocar audio
link css - para criar um arquivo unico para mexer no estilo 
height - altura da imagem usar junto com img
backgorund - image - linear gradiente = para fazer uma degrade das cores 
padding - preenchimento
border - borda
margin - margem / podemos utilizar para centralizar 
border - borda
margin - margem / podemos utilizar para centralizar 
header = div
main = div
footer = div
section = sessão
nav - navegação
box shadow = vertical horizontal e vertical e cor